KUR = "countries/Kurdistan.txt"
BAV = "countries/Bavaria.txt"
PRS = "countries/Prussia.txt"
LBR = "countries/Litbel.txt"
KRL = "countries/Kurland.txt"
KFR = "countries/Karelia.txt"
NCR = "countries/North Caucasian Republic"
GAL = "countries/Galicia.txt"
TNC = "countries/Transcarpathia.txt"
MOL = "countries/Moldovia.txt"
RSR = "countries/Russian Soviet Republic.txt"
FER = "countries/Far-East Republic.txt"
IND = "countries/India.txt"
FNA = "countries/French North Africa.txt"
FWA = "countries/French West Africa.txt"
NIG = "countries/Nigeria.txt"
ESF = "countries/Egypt-Sudan Federation.txt"

SNG = "coutries/SOVbritish.txt"
IRE = "countries/Ireland1.txt"
ENG = "countries/United Kingdom1.txt"
SCO = "countries/SCO.txt"
COR = "countries/COR.txt"
WAL = "countries/WAL.txt"
LIB = "countries/LIB.txt"
BOS = "countries/BOS.txt"
RHI = "countries/RHI.txt"
KUO = "countries/KUO.txt"
SCA = "countries/SCA.txt"
ZHI = "countries/ZHI.txt"
GUO = "countries/GUO.txt"
KRI = "countries/KRI.txt"
YAK = "countries/YAK.txt"
GIL = "countries/GIL.txt"
KAZ = "countries/KAZ.txt"
TOR = "countries/TOR.txt"
FIR = "countries/FIR.txt"
KIR = "countries/KIR.txt"
USB = "countries/USB.txt"
TAD = "countries/TAD.txt"
TYR = "countries/TYR.txt"
BYK = "countries/BYK.txt"